Ficha limpa – Gusttavo Lima – Sony
Morena – Luan Santana – Som Livre
Arranhão – Henrique e Juliano – Independente
Você beberia ou não beberia? – Zé Neto e Cristiano – Som Livre
Batom de cereja – Israel e Rodolffo – Som Livre
Baby me atende – Matheus Fernandes, Dilsinho – Som Livre
Desbloqueado – Diego e Victor Hugo – Sony
Coração cachorro – Avine Vinny, Matheus Fernandes – Independente
Expectativa x realidade – Matheus e Kauan – Universal
Os meninos da Pecuária – Léo e Raphael – Som Livre
Sigilo – Guilerme e Benuto – Sony
De repente a gente – Bravana – Believe
Se joga no passinho – Brisa Star ft Thiago Jhonathan – Independente
Coração de isca – Bruno e Marrone – Independente
Troca – Jorge e Mateus – Som Livre
Não parei de sofrer – Gustavo Mioto – Universal
Meu pedaço de pecado – João Gomes – Warner
Nota de repúdio – Gusttavo Lima – Sony
Facas – Diego e Victor Hugo ft Bruno e Marrone – Sony
Não, não vou – Mari Fernandez – Waguim
Coração na cama – Hugo e Guilherme – Som Livre
Troca de calçada – Marília Mendonça – Som Livre
No llores más – Simone e Simaria ft Sebastian Yatra – Universal
Trouxamente – João Gabriel ft Humberto e Ronaldo – Independente
Todo mundo menos você – Marilia Mendonça, Maiara e Maraisa – Som Livre
Por causa de você – Leo Chaves – Independente
Só na vontade – Marcos Brasil – Independente
Melhor que muita gente – Israel e Rodolffo – Som Livre
Chama ela pra mim – Eduardo Costa – Independente
Amando individual – Felipe Araújo e Gusttavo Lima – Warner
Estado frágil – Marcos e Belutti – Sony
Chega e senta – John Amplificado – Independente
Paradigmas – Jorge e Mateus – Som Livre
Foi pa pum – Simone e Simaria – Universal
Cold heart (PNAU Remix) – Elton Jhon, Dua Lipa – UMG
Sigo iludido – Diego e Ramon ft Bruno – Independente
Vou ter que tomar uma – Zezé Di Camargo – Independente
Cê tá preparada – Tayrone ft Marilia Mendonça – Universal
Revoada no colchão – Zé Felipe, Marcynho Sensação – Som Livre
Cena de amor – Brisa Star ft Zé Vaqueiro – Independente
A raiva que eu tô – Beline Braga – Independente
Plágio – May e Karen, Marcos e Belutti – Som Livre
Senta danada – Zé Felipe, Barões da Pisadinha – Som Livre
Passatempo – Wesley Safadão – Som Livre
Outra pessoa – Franklin e Daniel – Warner
Esquema preferido – Barões da Pisadinha – Sony
Saudade carinhosa – Mari Fernandez – Sony
Bad habits – Ed Sheeran – Warner
Beggin – Maneskin – Independente
Rolê (Vai beber, vai chorar, vai ligar) – Tarcísio do Acordeon, Marcynho Sensação – Independente
Seu flanelinha – Luccas Fernandes – Independente
Porre – Dilsinho – Sony
Tipo ifood – Os Barões da Pisadinha – Independente
Volta comigo bb – Zé Vaqueiro – Independente
Tey tey tey – Zé Ricardo e Thiago, Raí Saia Rodada – Independente
Leave the door open – Bruno Mars ft Anderson .Paak, Silk Sonic – Warner
Só me ama – Jotavê, Vitor Fernandes – Independente
Lance individual – Jorge e Mateus – Som Livre
Alive (It feels like) – Alok – Spinnin’ Records
Novinha – Lucas e Loretto ft Israel Novaes – Sony
Quanto tempo faz – Thiaguinho, Sorriso Maroto, Bruno Cardoso – Som Livre
É problema – Matheus e Kauan – Universal
My universe – Coldplay, BTS – Warner
Ainda tô ai – Eduardo Costa – Talismã Music
Vou ver e te aviso – Pixote – Independente
Pulei na piscina – Guilherme e Benuto – Sony
Alô ambev – Zé Neto e Cristiano – Som Livre
Diferença mara – Juliette – Universal
Say so – Doja Cat – Som Livre
Zero saudade – Os Barões da Pisadinha ft Mariara & Maraisa – Sony
Tipo gin – MC Kevin O Chris – Independente
Save your tears – The Weeknd – Universal
Café e amor – Gusttavo Lima – Sony Music
Recairei – Os Barões da Pisadinha – Sony Music
Espetinho – Gusttavo Lima – Sony
Investe em mim – Jonas Esticado – Som Livre
Último beijo – Bruno e Marrone ft Wesley Safadão – Believe
Faz amor comigo só hoje – Israel e Rodolffo ft Wesley Safadão – Som Livre
Ele é ele, eu sou eu – Wesley Safadão ft Barões da Pisadinha – Som Livre
Acaso – Vitor Fernandes – Independente
Watermelon sugar – Harry Styles – Columbia
Peaches – Justin Bieber ft Daniel Caesar, Giveon – Independente
Kiss me more – Doja Cat ft SZA – RCA
Antes de ir – Taty Pink ft Romeu – Independente
Despedida de casal – Gusttavo Mioto – Independente
Amor só quero com você – Lucas e Loretto – Sony
Girl from Rio – Anitta – Warner
Blinding lights – The Weeknd – Republic
Só não divulga – Fernando e Sorocaba ft Tárcisio do Acordeon – Sony
1 hora e meia – Zezé Di Camargo e Luciano – Onda Musical
Tapão na raba – Raí Saia Rodada – Som Livre
Don’t start now – Dua Lipa – Warner Music
Escuta e volta – Diego Extorado – Independente
Se for amor – João Gomes, Vitor Fernandes – Independente
Alvejante – Priscila Senna ft Zé Vaqueiro – Believe
Ela e Ela – Zé Neto e Cristiano – Som Livre
Minha pequena – Léo Magalhães – Independente
Eu topo – Sorriso Maroto – Sony
Liberdade provisória – Henrique e Juliano – Independente
Quero ver é me esquecer – Barões da Pisadinha ft Jorge – Sony